1111111111111
10C10000000E1
1000011C11101
1P0011110C001
1111111111111
