1111111111
1P00000001
1011111101
10C0E00C01
1011111101
10000000C1
1111111111
