11111111111111111111111111111
1C0000CCCC000000000C000000111
1000101000000001C101000001001
1P001E100000000CCCC0000001001
11111111111111111111111111111
