111111111111111
1P000000000C001
101111111111101
100000C00000001
111111101111111
1C0000101000001
101110101011101
10E010C01000C01
101110111111101
111111111111111
