11111111111111111111
1P000000000000000001
10111111111111111101
1000C00000000000C001
11111011111111110111
10000010000000010001
10111010111111010111
100C0000100000000001
11111111101111111101
1000000000C000000101
1011111111111110C101
10000000000000100101
10111111111111100101
100000000000000E0001
11111111111111111111
