111111111111111111111
1C0000CCCC000000000C1
1P001E100000000CCCC01
111111111111111111111
